09,09,09,17,22,10,10,10,10,10,13,09,09,09,09,09,09,08,01,01,09,09,16,10,10
09,09,09,09,16,10,10,10,10,20,14,09,09,09,09,09,09,07,00,00,02,09,16,10,10
09,09,09,09,17,15,15,15,15,14,09,09,09,09,09,09,07,00,00,00,04,09,16,10,10
12,09,09,09,09,09,09,09,09,09,09,09,09,18,12,09,06,05,05,04,09,09,16,10,10
19,12,09,09,09,01,01,01,09,09,09,09,18,21,19,12,09,09,09,09,09,18,21,10,10
20,14,09,09,07,00,00,00,09,09,09,18,21,10,20,14,09,09,09,09,18,21,10,10,10
13,09,09,09,06,05,00,00,04,09,09,16,10,10,13,09,09,09,09,18,21,10,10,10,10
13,09,09,09,09,09,05,04,09,18,11,21,10,10,19,12,09,09,18,21,10,10,10,10,10
19,11,11,12,09,09,09,09,18,21,10,10,10,10,20,14,09,09,17,22,10,10,10,10,10
10,10,20,14,09,09,09,09,16,10,10,10,20,15,14,09,09,09,09,17,15,22,10,10,10
10,10,13,09,09,09,09,09,16,10,10,10,13,09,09,09,09,09,09,09,09,16,10,10,10
10,10,19,12,09,09,09,09,17,15,22,10,13,09,09,09,09,09,01,02,09,17,22,10,10
10,20,15,14,09,08,01,01,02,09,16,10,13,09,09,08,01,00,00,03,09,09,16,10,10
10,13,09,09,09,07,00,00,03,09,16,10,13,09,09,06,05,00,00,03,09,09,16,10,10
10,19,11,12,09,06,05,05,04,09,16,10,13,09,09,09,09,06,05,04,09,09,16,10,10
10,10,10,13,09,09,09,09,09,09,16,10,19,12,09,09,09,09,09,09,09,09,17,22,10
10,10,10,19,11,11,11,11,12,18,21,10,10,13,09,09,09,09,09,09,09,09,09,16,10
10,10,10,10,10,10,10,10,19,21,20,15,22,19,11,11,12,09,09,09,09,09,09,16,10
10,10,10,10,10,10,10,10,10,10,13,09,17,22,10,10,19,11,11,12,09,09,09,16,10
10,10,10,10,10,10,10,10,10,10,13,09,09,17,22,10,10,10,10,19,11,11,11,21,10

